5 6
######
# # ##
#H  ##
# # C#
######
