17 23
#######################
#       #       #     #
### ##### # ### # ### #
#   #     # #     #   #
# # # ##### ####### ###
# # #     #     #C    #
# ####### ##### #######
#     #   #   #       #
# ### # ### # ####### #
# # #   #   #       # #
# # ##### ######### ###
# #     #         #   #
# # ### ######### # # #
# #   #       #   # # #
# ### ####### ##### # #
#     #             #H#
#######################
