5 5
#####
## ##
#CH #
## ##
#####
